[config]
name = map2
imgSrc  = /root/vector/map/map.png
tileW = 16
tileH = 16
width = 680
height = 490
scale = 1
[data]
1,1,1,1,1,1,3,3,3,1,1,1,1,1,1
1,1,1,1,1,3,1,1,1,3,1,1,1,1,1
1,1,1,1,1,1,1,1,1,3,1,1,1,1,1
1,1,1,1,1,1,1,1,3,1,1,1,1,1,1
1,1,1,1,1,1,1,3,1,1,1,1,1,1,1
1,1,1,1,1,1,3,1,1,1,1,1,1,1,1
1,1,1,1,1,3,1,1,1,1,1,1,1,1,1
1,1,1,1,3,3,3,3,3,3,3,1,1,1,1



